                                                                                                                                P
                                                                                                                                P
                                                                                                                                P
            WWWW    WWWW    WWWW                                                                                                P
                                                                                                                                P
                                    WWWW                                         W  H W   WWW                                   P
        WWWW    WWWW                                                           WWWWWWWW                       WWWWWWWWWWWWWWWWWWW
                                                         W W  WW    WW                                WWWWWWWWW                 o
                                        W            H   W W  WWH   WWW                          WWWWWW                         o
WWWWWWWWWWWWWWWWWWWWWWWW            WWWWWWWWWWWWWWWWWWWWWWWWWWWWWWWWWWWWWWWWWWWWW    WWWWWWWWWWWWW                              o
                    W     H     WWWWW                                           WWWWWW                                          o
                    WWWWWWWWWWWWW                                                                                               o