                                                                                                              
                                                                                                              
                                                                                                              
                                                                                                              
                                                                                                             
                                                                                                             
                         WWW            WWWWWW                                                    WWWW       W
                  WWW                   W    W                      WWWWWW                       WW  W       W
W                            H WWWWWW   W    W                      W    W         H            WW   W      PW
WWWWWWWW    WWWWWWWWWWWWWWWWWWWW   WWWWWW    WWWWWWWWWWWW     WWWWWWW    WWWWWWWWWWWWWWWWWWWWWWWW    WWWWWWWWW  
       WWWWWW                                           W     W                                                
                                                        WWWWWWW                                                